NO ./textures/wall_n.xpm
SO ./textures/wall_s.xpm
WE ./textures/wall_w.xpm
EA ./textures/wall_e.xpm
F 220,100,0
C 225,30,0


111111111111111111111111111

111111111101100000000000011111
10110000011100000000000011111
10010000000000000000000011111
11111111101100000111000011111
10000000001100000111011111111
11110111111111011100000010001
11110111111111011101010010001
11000000110101011100000010001
11000000111110000000000000001
1N000000100110000000000000001
 111000001111000000000000011
10110100011100000000000000001
11111 111111111111111111111111
