NO ./textures/wall_n.xpm
SO ./textures/wall_s.xpm
WE ./textures/wall_n.xpm
EA ./textures/wall_e.xpm
F 220,100,0
C 225,30,0

    11111111111111111111111111 1111 1
    1000000000110000000000001  11111111
    11110000011100000000000011111111111
    111111001000000000000000000001111
1111111110110000011100000000000011   1
100000000011000001110111111111111111111   11
11110111111111011100000010001
11110111111111011101010010001
110000001111010111000000100011111111
10000000100111111 100001100000010001
10000000000000001101010010001111111111
11000001110101011111011110N011111    11
11110111111101111101111010001   111 1101
11111111111111 1111111111111111111  111
